25 20
#############
#...........#    ########
#...s...s...######p.....#
#.......................#
#...........######......#
#.....s.....#    #......#
#...........#    #...s..#
#...........#    #......#
#####..######    ###..###
    #..#           #..#
    #..#           #..#
    #..#          ##..##
  ###..####      #......#
  #..@....#      #......#
  #.......#      #......#
  #.......#      #...s..#
  #.......#      #......#
  #.......#      #......#
  #.......#      #......#
  #########       ######