25 15
#########################
#@......#.......#......D#
#.#######.#####.#.#######
#.....r.#.....#.#.......#
#####.#.#####.#.#######.#
#.....#.....#.#.......#.#
#.#########.#.#######.#.#
#.#.......#.#.....#...#.#
#.#.#####.#.#####.#.###.#
#.#.#...#.#.....#.#.....#
#.#.#.#.#.#####.#.#######
#.#.#.#.#.....#.#.......#
#.#.#.#.#####.#.#######.#
#...#.........#.....k...#
#########################